111111111111111111111111
110E0111C00000000000CCC1
1100000001100000000011C1
1CCC00000100000000001CC1
1C1100000000010000000P11
1CCC00000000110000000111
111111111111111111111111