11111111111111111111111111111111111111
11CCCCCCCC1CC01111CCCCCCCCC111CCCCC111
1CCCC11CCCC1CCCC01CCCC1CCCCCC0101CCCC1
111CCCCCCCCC01010CCCCCCCCCCCCC01CCCC01
111CC11110101CCCCCCCCCC1CCCC1CCCCCC0C1
111CCCC1CC101010101CCCC101CCCCCCCC0101
111CCCCCCCC0C10C11110CCC1CC01CCCCCCCC1
111CCCCCC0111CC101CCCC0C1CCCC01CCCC101
111CCCC011CCCC101CC011CCCCCC111CCCC011
111CCCC1CCCC01C01CCCCCCCCCCC0110CCC101
111CCCCCCCC0101CCCCCCCC11CCCCCC1CCCC01
1CCCC101CC1CCCC0101CCCCCCCCCCCCCCCCCP1
101CC1CC1010101CC01CC1CCCCCC01111CC111
1CCCC1CCCC01111CC01CCCCC0111CCCE1CC011
11111111111111111111111111111111111111