111111111111111111111111111111111111
110000000010000111100C000000111E0111
100001000010000010000100000001010001
111000000000101000000000000001000001
100001010010000010100000000000000001
101001001010101000100100000001011111
1P0001000001111000100000011100001011
111111111111111111111111111111111111