11111111111111111111111111111111111111
10E0001111000000C000111111100C00010111
1000011110000C000011111110000011001111
100C0111100000001110000000000001100111
1000011110000C000011111110000011001111
100C0111100000001110000000000001100111
1000011110000C000011111110000011001111
100C0111100000001110000000000001100111
1000000000000C00000000011100C001100P11
10000011110000000001111111000001101111
11000C0111100000011111110000C000111111
11111111111111111111111111111111111111