111111111101111
1100000000000E1
111110000001111
10000C0000000P1
111111111111111