111111111111111
110000000000RE1
111110000001111
1P000C000000001
111111111111111