111111111111111
1100000000000E1
111110000011111
1C1000C000100P1
111111111111111