1111111111111111111111111
10R1111111111110R00000R01
1000RRRRRRR11100000R00001
10000000000011001111111C1
1000RRR0000011000110E1111
101C100010100000000010P01
1011101010111001110000001
100000000000000C111111111
1111111111111111111111111