1111111111111
1000000P000R1
10CR001111001
100E10C0000C1
1111111111111